1111111111111
1000000000C01
10E0011110001
1000000011111
10001100000P1
1111111111111
